111111111111111111
1000000000C0000001
10000C010000000E01
1C0000010000000111
10000000000P111110
111111111111111111