111111111111111111
1000000000X0000001
10000X010000000E01
1X0000010000000111
1000000000XP111110
111111111111111111