1111111111111111111111
10000000000P00000C00E1
1111111111111111111111