11111111111111
1000PCC0E00C01
11111111111111