11111111111111
1000PCCCE00001
11111111111111