11111111111111
1000PEC0000001
11111111111111