11111111111111
1000P0C0E000C1
11111111111111