11111111111111
1000PCC0E00001
11111111111111