111111111111111111
100C00000000V01001
10000001P0000100C1
100000000V01000111
10E000010000111111
111111111111111111