111111111111111111
1P0C00000000000001
1000000100000001E1
100000010000000111
100000000000111111
111111111111111111