111111111111111111
1P0C00000000001001
1000000100000100E1
100000000001000111
100000010000111111
111111111111111111