111111111111111111
100C00000000000001
1000000100000000E1
100000010000000111
1000000P0000111111
111111111111111111