111111111111111111
10C000V000000V1001
10000001P000010C01
111110000001000111
10E0000100R0111111
111111111111111111
