111111111111111111
1P0100000000001001
10CCCCC00000010C01
10CV0C0C00C0000001
10C00CCCCCC0C00C01
10C00CC0CCCCC00001
100001000C0C0C0001
10001101000V0001E1
111111111111111111