111111111111111111
100P00000010000001
100001010000000E01
110000010000000111
100000000010111110
111111111111111111