11111111111111
1000PCC0E00001
10000CC0000001
10000CC0000001
11111111111111