111111111
1P0C00001
100CCC001
10C0C0CE1
111111111