111111111111111111
1P000000C000001001
101111100000010101
10100101001000C001
101001111110100101
10C00C101111100001
100001000C010C0001
10001101000V0001E1
111111111111111111